*******************
*            *    *
*   *        *    *
*       @    *    *
*                 *
*  *****          *
*                 *
*******************