*******************
*            *    *
*   *   @    *    *
*            *    *
*                 *
*  *****          *
*                 *
*******************