*******************
*            *    *
*   *        *    *
*           @*    *
*                 *
*  *****          *
*                 *
*******************